#######################################################
#             #                 #   #             #   #
# ######### # ##### ############# # # ### ####### # # #
# #       # # #     #             #   #   #     #   # #
# ### ### # # # ##### ################# ### ### ##### #
#   # #   # # #     #             #   # #     #   #   #
### # # # # # ##### ##### ######### # # ####### # # ###
# # # # # # #         #   #         #   #     # # # # #
# # ### ### ######### # ### ####### ##### ### ### # # #
# #     #   #   #     # # # #       #   #   #     # # #
# ##### # ### # ##### # # # ####### # # ### ##### # # #
#   #   #     #     #B#   #       # # # #   #     # # #
### # ########### # ##### ####### ### # # ######### # #
#   #   #   #   # # #     #     # #   # #           # #
# ##### # # # # ### # ####### # # # ### ##### ####### #
# #       # # # #A# # #       # #   # #     # #     # #
# # ######### # # # # ##### ### ##### ##### # # ### # #
#   #     #   #   # # #   # # # #     #   # #   #   # #
##### ### # ####### # # # # # # # ##### # # ##### ### #
#     # #   #     #     #   #     #     #   #   # #   #
# ##### ######### # ############# # ######### # # ### #
#      A        #B  #   #     #   # #         # #   # #
############### ##### # # ### ### # # ############# # #
#       #A    # #   # #   # #   # # # #  A  #     #   #
# ##### # ### # # # # ##### ### ### # # ### # ### ### #
#   # # # # # #B# # # # #   #A  #   # # # #B# # # #   #
### # # # # # # # # # # # # # ### ### # # # # # # # ###
#     #     #     #   #   #    B  #       #     #     #
#######################################################
