#######################################################
#A  #       #               #         #   #   #     # #
### # ### # # ##### ### ##### ### ### # # # # # ### # #
# # #   # # # #   #   # #     # #   # # #   #   # #   #
# # ##### ### # ##### # # ##### ### # # ######### ### #
# #     #   # # #     # #       # # #   #           # #
# ##### # # # # # ############# # # ##### ########### #
#       # #     #         #   #   # #   #             #
# ######### ############# # # ### # # ### #############
# #       # #     #     #   #     # #     #     #     #
# ##### # ### ### # ### ### ####### # ##### ### ##### #
#       #     #   # #     #   #     # #     #   #     #
############### ### ##### ##### ##### # ##### ### ### #
#   #     #   # #       #     #   # # #   # #   # # # #
# # ### # ### # ####### ##### ### # # ### # ### # # # #
# #   # # #   #         #   # #   # #     #   # # #   #
# ### # # # # ############# # # ### ####### # # # # ###
# #     # # #   #   #       #   #       #   # #   #   #
# ####### # ### ### # ### ####### ##### # ### ####### #
#       # # # #   # # # #       #   # # # # # #     # #
####### # # # ### # # # ##### # ### # # # # # # ### # #
#     # #   #   #   # # #     #   # # # #   # #   # # #
# ### # ##### ### ### # # ####### # # # ### # ### # # #
# #     #   #     #   # #     #     # #   # #   # #   #
# ####### # # ##### ### ##### # ##### # ### # # # #####
#   #   # #   #   #   #   #   # #   #   #   # # #     #
# # # # ####### # ### ### # ##### # ##### ### ####### #
# #   #         #         #       #         #        B#
#######################################################
