#######################################################
#       #       #           #                   #     #
### ### # ##### # # ####### ##### ####### ##### ##### #
#   # #   #   # # #   #   #     #     #   #   # #   # #
# ### # ### # # ##### # # ##### ##### # ### # # # # # #
#   #   #   # #       # #       #   # # #   # # # #   #
# # ### # ### ############# ##### # ### ##### # # #####
# #   # #   #       #     #       #     #   #     #   #
# ### ##### ####### # ### ######### ##### # ####### # #
# # #     #   #       # #   #     # #   # #     #   # #
# # ### ##### ######### ### # ### # # # # ##### # ### #
#   # # #   #       # #   #   #   # # # #   # # #   # #
### # # # # ####### # # # ##### ##### # ### # # ### # #
#     #   #   #     #   #     #     # #     # #     # #
######### # ### # ####### ######### # ####### ####### #
#       # #   # # #     # #B      #   #     #   # #   #
# ##### ##### # ### ### # # ##### ##### ### # # # # ###
# #   #       #       # #   # #       #   # # #   #   #
# # # ### ########### # # ### # ##### ### # # # ##### #
# # # #   #     #  A# # #   # # #     #   #   # #   # #
# # # ### # # # # ##### ### # # ##### # ######### # # #
#   #   # # # # #       # # # # #   # # #         #   #
# ##### ### # ########### # # # # # # # # #############
#   # #   # #         #   #   #   # # # # #     #     #
### # ### # ######### # # ### ##### # # # ##### # ### #
# # #   #   #       # # #   # #   # #   # #   #     # #
# # # # ####### ### # # # ### # # # ##### # # ####### #
#     #         #   #   #       # #         #         #
#######################################################
