#######################################################
#A#     #       #   #   #       #       #       #     #
# # ### # ##### # # # # # ### ### # ### # ##### # # ###
# #   #     #   # #   #     #     #   # # #   #   #   #
# ### ####### ### ######### ####### # # # # ######### #
#   #   #     #     #     #   #   # # # #   #       # #
### ##### ##### ##### ### ##### # ### # ##### ##### # #
# # #   #       #   # #   #   # #     #       # #   # #
# # # # # ####### # # # ### # # ############### # ### #
# #   # #     #   #   #   # # #     #     #     #     #
# ##### ####### ######### # # # ### ### ### # ####### #
#     #       # #     #   # # #   #   #   # #       # #
### ######### # # ### # ### # ##### # # # # ### # ### #
#   #     #   #   #   #   # #     # # # # # #   # #   #
# ### ### # ##### # ##### # ##### ### # # # # ##### ###
#       # #     # #     #   #   # #   # #   # #     # #
######### ##### # ##### ##### ### # ######### # ##### #
#         #     #     # #       # # #     #   # #     #
# ### ##### ##### ##### ####### # # # # # # ### # #####
# #   #     #   # #     #     # # # # # # # #   # #   #
# ##### ##### # # # ##### ### # # # ### # # # ### # # #
# #     #   # #   # #     #     #   #   #   # #     # #
# # ##### ### ##### # ##### ######### ##### # ##### # #
#   #   #   #     # #   #   #         #     #     # # #
# ### # ### ##### # # # # ### ### ##### ######### ### #
#     #   #       # # # # #   #   #     #       # #   #
######### ######### # # ### ### ######### ##### # # # #
#                   # #       #               #     #B#
#######################################################
