#######################################################
#           #       #         #     #         #     # #
# # ####### # ##### # ####### # ### # ####### ### # # #
# # #   #   #   #   #     #   # #   #   # #   #   #   #
# # # # # ##### # ##### # # ### ### # # # # ### #######
# #   # #       #     # # # #     # # # #   #         #
# ##### ############# ### # ##### # ### ### ####### # #
#   # #   #     #   #     #     # #   #   #       # # #
### # ### # # ### # ### ####### # ### ### ####### ### #
# # # #   # #     #     #   #   # # #     #     # #   #
# # # # ################# # # ### # ####### ##### # ###
# # # #         #     #   # # #   #         #     #   #
# # # ######### # ### # ### # # ### # ####### ####### #
# #       #     # # #   #   # # #   # #       #       #
# ### ##### ##### # ##### ### # ### ### ####### #######
#     #   #     #     #   # # #   # #   #       #     #
####### # # ### ##### # ### # ### # # ### ### ### ### #
#       # # # #     # # # #   #   #   #   #   #   #   #
# ####### # # ##### # # # # ### ### ##### # ### ### # #
#   #     # #     #   # #       # # #     #   # #   # #
# # # ##### # ##### ### ######### # ### # ##### # ### #
# # #     #   #   #   #  B  # #   #   # # #   # # #   #
### ##### ##### # ### ##### # # # ### # ### # # # ### #
#   #       #   #   #   #   # # #     #     #   #   # #
# ######### # ##### ##### ### # ######### ######### # #
# #     #   # #   # #     #     #       #     #   # # #
# # ### # ### # ### # ##### ##### ##### ####### # # # #
#   #A  #     #       #           #             #   # #
#######################################################
