#######################################################
#         #     #       #     # #     #               #
####### ### # ### # ##### ### # # # ### ##### ####### #
#     #   # #     #       # # #   # #   #   #     #   #
# ### ### # ############### # # ### # ### # ##### # # #
#   #     # #       #       #A#   #   #   # #   # # # #
# # # ##### ##### ### ### ####### ##### ### # # ### # #
# # # #   #     #     # #       #   # # #     # #   # #
# # ### # ##### # ##### ####### ### # # ####### # #####
# #   # #   #   #       # #   #     # #   #     #     #
# ### # # ### ######### # # # ####### ### # ######### #
# # #   #     #     #   #   #         #   #         # #
# # ############# # ### ##### ### ##### ########### # #
# #     #   #     #   #   #   #   #   #   #     #   # #
# # ### ### # # ##### ### # ####### # # # # ### # ### #
#   # #   # # #     #   # # #     # # # # #   # #   # #
##### ### # # ##### ### # # # ### # # ### # # ##### # #
#   #     # # #   # #   #   # #   # # #   # #     # # #
### # ##### # # ### # ##### # ### # # # ### ### # # # #
#   # # #       #   #   #   #   # # #   #     # # # # #
# ### # # ####### ##### ####### # # ######### # ### # #
#     #   # #   #   # #         # #   #   #   #       #
# ####### # # # ### # ########### ### # # ########### #
# #     #   # #     #           #   #   #     #   #   #
# # ### ##### ####### ### ##### ### ####### # # # # ###
# #   #     #   #  B  # #   #     #       # #   # #   #
# ### ##### ### # ##### ### ############# ####### ### #
#     #         #         #                       #   #
#######################################################
