#######################################################
#                 #                   #               #
# ######### ##### # ######### # ##### # ##### ####### #
#     #     #B  # #       # # # #   # # #   #     # # #
### ### ### # # ######### # # ### # ### # # ##### # # #
#   #   #   # #   #     # # # #   #   #   #     # #   #
##### ##### # ### # # # # # # # ##### ### ####### ### #
#     #   # #   #   # # # # #   # #     # #     #   # #
# ##### # ##### ##### ### # ##### # # ### # ### ### ###
# #     # #     # #   #   #   #   # # #   # # #   #   #
# # ##### # ##### # ### ### # ### # ### ### # ### ### #
#   #   #   #     #     #   #     #   #   # #     #   #
# ##### ######### ######### ##### ### ### # ##### # ###
# #       #       #   #     #   # # #   # #     # #   #
# ### ### ### ### # ### # ### ### # ### # ##### # ### #
#     # #     #   #     # #     # #   #   #   # #   # #
####### ####### ### ##### ##### # ### ##### ### ### # #
#       #   #   # # #     #     # #       #   #A# #   #
# ##### # ### ### # # ##### ##### # ##### ### ### #####
# #   #   #   #   # #   #   #     # #   #     #       #
# # # ##### ### # # ### # # # ##### # # ##### # # #####
#   # #     #   #   #   # # # #   # # #   #   # #     #
##### # ########### # ##### # # # # ### # # ####### # #
#     # #         # # #     # # # #   # #   #     # # #
# ##### ### ##### ### # ##### # # ### # ##### ### ### #
#     #     #   #     #     # # #     #   #   # # #   #
# ### ####### ######### ### # # ######### # ### # # # #
#   #                     #     #           #       # #
#######################################################
