#######################################################
#         #       #           #       #    B    #     #
# ####### # # ##### ##### ### # # ### # ####### # ### #
#       # # #       #     #   # #   # # #       #   # #
# ##### ### ######### ##### ### ### # # # ######### # #
# #   #     #       #   # # #     # #   #           # #
# # # ############# ### # # ##### # ##### ########### #
# # # #               # # #     # #     # #A# #   #   #
# # # # ############# # # ##### ##### # ### # # # # ###
#   #   #           # # #           # # #   #   #   # #
######### ### ####### # ##### ##### ### # ### ####### #
#         # # #       # #   # #   #     #   #   #     #
# ######### # # ####### # # ### # ######### ### ### # #
# #   #   #   #       #   #     #   #     #   #   # # #
# # # # # ### ##### ############### # # ##### ### # # #
#   #   #   #   #   #     #       #   # #   #   #   # #
# ######### ##### ### ### # ##### ##### # # ### ##### #
# #       #         # #     #     #     # # #   #     #
# ### # ############# ######### ### ### # # # ### #####
#     # #             #       #     #   # # #   # #   #
####### # ######### ### ##### ########### # ### # # # #
#   #   # #         #   #   # #         # #   # #   # #
# ### ### ####### ### ##### # # ####### # ### # ##### #
#   #   #       # #   #     #   #       #   # # # #   #
# # ### ####### ### ### ### ##### ### ### ### # # # ###
# #   # #     # #   #   # #     #   # #   #   # # #   #
# # ### ### # # # ### ### ##### ### ### ### ### # ### #
# #         # #       #           #       #     #     #
#######################################################
