#######################################################
#   #     #  B    #             # #             #     #
# ### # ### ##### # ####### ### # # ##### ##### # ### #
# #   #     #   #     #     # # #   #   # #       #   #
# # ########### ####### ##### # # ### # # ########### #
# # #   #         #     #   #   #   # # #   #   #   # #
# # # # ### ##### # ####### # ##### ### ### # # # # # #
# #   # #   # #   #       # #   #       # #   #   # # #
# ##### # ### # ######### # ### ####### # ######### # #
#     #   # #   # #     # #   #     # #     #   #   # #
### # ##### # ### # ### # # ####### # ##### # ### ### #
#   # #     # #   # #   # #       # #       #   # # # #
# ### # ### # ### # # ### # # ##### ##### ##### # # # #
# #   # #   #   #   # #   # #           # #     # #   #
# ### ### # ### ##### # ### ########### # # ### # ### #
#   #   # # # # #   # #   #   #   #   # #   #   #   # #
# # ### # # # # # # # ### # ### # # # # # ######### # #
# #   #   #   #   #   # # # #   #   # # # #         # #
# ### ####### ####### # # # # ####### # ### # ####### #
# # #   #     #       # # # # #   #   #     # #     # #
# # ### ####### ####### # # # # ### ####### ### ### # #
#   # #         #       # # # #   # #     # #   # # # #
### # ########### # ##### # # ### # # ### # # ### # # #
# #     #       # # #     # #   # # #A# # # #   #   # #
# ##### # ##### # # # ##### ### # # ### # ##### # ### #
#       #   # #   # # #       # # #     #       # #   #
# ######### # ##### # ######### # ### ########### # ###
#           #       #               #             #   #
#######################################################
