#######################################################
#       # #             #             #               #
##### # # # ########### ##### # ##### # ##### ####### #
#     #   # # #       # #   # # # #   #   #   # #     #
# # ####### # # # ### # # # ### # # ####### ### # #####
#B# #     # #   # # # #   # #   # # #       # #   #   #
# ### ### # ##### # # ##### # ### # ### ##### # ##### #
#   # # # #     # # # #   #   #   #     #     #     # #
### # # # ##### # # # # ####### # ######### ####### # #
#   #   #   #   # # # # #   #   #           #     # # #
# ##### ### # ### # # # # # # ####### ### ### # # # # #
#     # # #A# #   #   #   # #       #   # #   # # # # #
# # # # # ### ### # ### ### ####### ### # # ### # # # #
# # # #   #   #   # #   #     #   #   # # #   # # # # #
# # ##### # ### ### ##### # ### # # ### ##### # ### # #
# #     #   #   # #       # #   #   #   #     # #   # #
# ### # ####### # ### ####### ####### ### ##### # ### #
#   # #         #     #     # #     #     #   # # #   #
### # ################# ### # # # ########### # # # # #
#   #               #   #   # # #   #         #   # # #
# ############# ### # ### # # # ### # # ##### ##### # #
# #   #   #   #   # # # # # # #   #   # # #   #   # # #
# # # # ### # ##### # # # ### # ####### # # ### # ### #
# # #   #   #       # # # #   # #   #   # # #   #   # #
# # ### # ### ####### # # # ##### # # ### # ### ### # #
# # #   # #   #     #   # # #   # #   #   #   #   #   #
# # # ### ##### ### ### # # # # # ##### ##### ### ### #
#   #   #         #     #     #   #               #   #
#######################################################
