#######################################################
#           #       #             #     #           # #
# # ####### ### ##### ########### # ### # # ####### # #
# #       #   #     #   #       # # # # # #     # #   #
# ####### ### # ### ### ##### # # # # # # ##### # ### #
#     #   # # #   #   # #   # # #     #       # #   # #
####### ### # ####### # # # ### ############### # # # #
#       # #   #     # #   #   #   #         #   # #   #
# ####### # ### ### # ####### ### # ####### # ####### #
# #         #   # # #   #   #   # # #         #     # #
# ##### ##### ### # # # ### ### # # ##### ##### ### # #
# #   # #     #       #B    #   # #     # #     #   # #
# # # # # ################### ### ##### ### ##### ### #
#   # #   #                           # #       # # # #
# ### ### # ########################### # ####### # # #
# #   # # #       # #     #   #   #   # # #       # # #
# # ### # ####### # # ### # # # # # # # # # ####### # #
# # # #       #     # # # # #   #   # # # # #     #   #
# # # # ####### ##### # # # ######### # # # # # # # ###
# # #   #     # # #   # # #         # #   # # # # # # #
# # ##### ### # # # ### # # ####### # # ### ### # # # #
# # #     # # # # # #A#   #       # # # # #   # # #   #
# # # ##### # # # # # # ######### # # # # ### # ##### #
# # #     # # #   #   # #     #   # # #   #   # #   # #
# # ##### # # ### ##### # ### ##### # ##### ### # # # #
# # #   #   #   #     # # #   #     # #   # #     # # #
# # # # ### ### ##### # # # ### ##### # # # # ##### # #
# #   #       #       #   #     #       #   #     #   #
#######################################################
