#######################################################
#       #     #       #             #   #     # #     #
# ##### # ##### ##### # # ######### # # ### # # # ### #
# # #     #     #   #   #   #     # # #     # # # # # #
# # # ##### ##### ######### ##### # # ####### # # # # #
# #     #   #   #         #     # # # #   #   #   # # #
# ####### ### # ######### ##### # # # # ### ##### # # #
#   #     #   #             # # #     #         #   # #
# # # ##### ############### # # ####### ####### # ### #
# # #       #             # # #       # #   # # # #   #
### ################# ### # # ####### ### # # # ### # #
#   #               # #   # #     # #     # #       # #
# ### ####### ##### ### # # ### # # ####### ###########
#     # #   # #   #     # #   # #         #          A#
# ##### # # # # # ####### ### # ######### #############
#     # # # #   #   #   # # # # #     #   #   #       #
##### # # # ####### # # # # # # # # ### ### # ### # # #
# #   # # #     #   # #   # #   # #   # #   #   # # # #
# # ### # ### ### ### ##### ##### ### # # # ### ### # #
#   #       #   # # #     #     # #   # # # #       # #
# ############# # # ##### ##### # # ### # # ######### #
#         #   # # # #       #   # #     # #     #   # #
######### # # # # # # ##### # # # ############# # ### #
#       #   #   # #   #   #   # #   #           #   # #
# ##### ####### # ##### # ### ##### ### ######### # # #
#     #   #     # #     #  B# #   #   # #   #   # #   #
# ### ##### ##### # ####### ### # ### # # # # # # #####
#   #           #         #     #       # #   #       #
#######################################################
