#######################################################
#             #           #       # #      B      #   #
# ######### # ### # ##### # ##### # # ##### ####### # #
# #     #   #   # # #   #   #   # # # #     #       # #
# # ### # ##### ### # # ##### # # # # # ### # ####### #
# #   #   #   #   # # # #   # # # # # # #   #   #     #
##### ##### # ### # # ### # # # # # # # ### ### # ### #
#     # #   #     # #     #   # # #   #   #   # #   # #
# ##### # ######### # ######### # ##### # ### # ### # #
#   #   # #   #     # #       # #     # #   # # #   # #
### # # # # # ### ### # # ##### ##### # ### ### # #####
# #A# # #   # #   # # # # #       # # #   #   # #     #
# ### ####### # ### # # # # ##### # # # ##### # ##### #
#   #       #   #   #   # # #     # # # #   #     #   #
# ### ### # ####### ##### # # ##### # ### # ####### # #
#     #   #         #   # # #   #   # #   # #   #   # #
# ##### ### ####### ### # # ### # # # # ### # # # ### #
#   # # #   #     #     # # #   # # # # # # # # #   # #
### # # ##### ### # ##### # ### ### # # # # # # ### # #
# #   #       # # # #     #   #   # #   # #   #   # # #
# ### ######### # # # ####### ### # ##### ####### # ###
#     #         # # # # #   # # #           #     #   #
# ##### ####### # ### # # # # # ##### ####### ##### # #
#   #     #   # #   # #   # # #       #       #     # #
### ####### # # ### # # ### # ######### ####### ##### #
# #         # #   #   #   # # #     #   #       #     #
# ########### # # ######### # # ### # ########### ### #
#               #           #     #               #   #
#######################################################
