#######################################################
#     #   #     #         #   #         #       #     #
### # # ### ### # # ##### # # # ####### # ##### # ### #
#   #   #   # #   #   #     # #   #   # #     #   #   #
# ####### ### ####### ####### ### ### # ########### # #
# #               # #     #       #   #           # # #
# # ############# # ##### ######### ##### ####### # # #
# #   # #     #   # #   #     #     #     #   # #   # #
# ### # # ### # ### # # ##### # ##### ##### # # # #####
#       # #B# #     # #   #   #       #   # # #   #   #
# ####### # # ### ### ### # ########### # # # # ### # #
#   #   # # #   # #   # # #         #   #   # #   # #A#
# ### # # # ### ### ### # # ####### # ####### ##### ###
# #   # # # #   #   #   # # #     # #   #     #   # # #
### ### # # # ### ### ### # # ### # ### # ### # # # # #
#   # #   #   #   # #   # # # #       # # #   # # #   #
# ### ##### ### ### # # # # # ####### # # ##### # ### #
# #   #   # #   #   # #   # # #   #   # #       #   # #
# # ### # # ### ### # ####### # # ##### ######### # # #
# #     #       #   # #       # #       #     #   # # #
# ####### ####### ### # ### # # ######### ### # ### # #
#       #   #   #     # #   # #   #     #   #   #   # #
# ##### ##### # ### ##### ### ### # ####### ######### #
# #     #     #   #       #   #   # #     #   #       #
### ### # ####### ##### ####### ### # # # ### # #######
#   #   # # #     #     #     # #     # # # #   #     #
# ####### # # ########### ### # ####### # # ##### ### #
#           #               #           #         #   #
#######################################################
