#######################################################
#           #     #             #           #         #
# ### ##### # # # # ### ####### # ######### # # #######
# #   #   # # # # # # # #     # #   #     #   #       #
# ##### # ### # ### # # ### # # ### # ### ### ####### #
#       #     #   # # #   # #   #   #   #   #   #   # #
# ############### # # ### # ##### ##### ### ### # ### #
# #     #       #     #   #   #   #     #     #   #   #
# ##### # ### # ####### ##### ##### ######### ### # ###
#   #   # # # # #       #   #     #       #   #   #   #
### # ### # # ### ######### ##### ### ### # ######### #
# # #       #   #   #     #     #   #   # #           #
# # ########### ### # ### # # ##### ##### ########### #
# #       #       # # #   # #     # #     #       #   #
# ####### # ##### # # # ##### # ### # ########### # ###
#     #   #     # #   #     # #   #   #       #   # # #
# ##### ### ### # ######### # ### ### # ##### # # # # #
# #     #     # #       #   # #   #   # # #   # # # # #
# # ########### ####### # ##### ### ### # # ### ### # #
#   #    B  #   #     # # #   #     #   # #   #   # # #
# ### ##### # ### ### ### # # ####### ### ### ### # # #
#     #       #   #     #   #       # #   # #   # # # #
####### ####### # ##### ### ####### # # # # ### # # # #
#       # #   # # #   #   #   #   #     # # #   #   # #
# ####### # # # # # # ### ##### # ####### # # ### ### #
# #   #   # #   # # #   #       #   #   #   # # #   # #
# # # ### # ####### ### ########### # # ##### # ### # #
#   #     #           #  A#           #       #       #
#######################################################
