#######################################################
#           #     #                 #         #       #
# ######### # ##### ######### ##### # # ##### # ##### #
# #   #     #         #       # #   # # #     # #   # #
# # # # ##### ######### ####### # ### # # ##### # ### #
# # # #   #         #   #     #   #   # # #     #   # #
# # # ### ######### # ### ### # ### ### # # ####### # #
# # #   #       #   # #   #   # #     # # # #       # #
# # ########### # ### # ### ### # ##### # # # ### # # #
#   #           # #   #   # #   #   #   # # #B  # # # #
### # ########### # ##### # # ####### ### # ### # ### #
# # # #           #     # # # #     #   #   # # # #   #
# # # ######### ##### ### # # # ### ### ##### # # # ###
#   #   #     # # #   #   # #   #     # # #   # # # # #
# ##### # ### # # # ### ### ######### # # # # # # # # #
# #   #   #   #   #       #         #   #   # # # # # #
# ### ##### ##### ######### ####### ##### ### # # # # #
#   # #   # # #   #       #       #   #     # # # #   #
### # # # # # # ### ##### ##### ##### ####### # # ### #
# # # # # # # # # # #     #     #     #       # #   # #
# # # # # # # # # # ##### # ##### ##### ### ### ### # #
#   # # #A# # #   #     # #     #     #   # #   # # # #
# ### # ### # # ##### # # ########### # # ### ### # # #
#   # #     # # #   # # #           # # #   # #   #   #
### # ####### # # # ### ########### # # ### # # #######
#   #       #   # #     #   #     # # # #   # #       #
# ### ##### ##### ####### # # ### # # # # ### ### ### #
#     #           #       #     #     # #         #   #
#######################################################
