#######################################################
#       #         #   #       #     # #               #
# ##### ### ### ### # # ##### # ### # # ####### ##### #
#     #     # # #   #   #   #   # # #     #     #   # #
##### ####### # # ####### ####### # ##### # ##### ### #
#     # #       #B    #   #         #   # #   #       #
# ##### # ########### # # # ######### # ##### # #######
#   #   #     # #     # #       #     #     # #   #   #
### # ####### # # # ########### # ######### # ### # # #
#   # #       # # # #      A# # #   #   #   # # # # # #
# ### # ####### # ### ####### # ### # # # ### # # # # #
#   # #   #     #   # #     # #     # # #     # # # # #
# # # ### # # # ### # # ### # ######### ####### # # # #
# # #     # # #   # # # #   # #             #   #   # #
# # ##### ### ### # # # ### # # ##### # ##### # ##### #
# #     #     #   # # #   #   #   # # # #     # #     #
# ##### # ######### # # # ### ### # # ### ##### # #####
# #   # # #       #   # # # # # #   # #   # #   # #   #
# ### # ### ##### ####### # # # ### # # ### # ### ### #
#   # # #   #   # #       #       # # # #   #   #   # #
### # # # ### # # # # # ########### # # ### ### ### # #
#   # #   #   #   # # # #   #       # # #     #   #   #
# ### ##### ####### # # # # # ####### # # ### # ##### #
#   #     #     #   # # # #   #   #   #   # # #   #   #
### # # # ##### # ### ### ####### # # ##### # ### # ###
# # # # #   #   # # #   # #     # # # #       #   # # #
# # ### ### # ### # ### # # ### # # ### ####### ### # #
#       #   #         #     #     #           #       #
#######################################################
